5000000000005
0101010101010
0101010101010
0104010104010
5101010101015
0030000000300
3222222222223
0000000000000
0000000000000
0000000000000
0000000000000
0000000000000
0000000000000